19:1 06:2 00:2 01:2 00:2 01:2 00:2 01:2 00:2 01:2 00:2 01:2 00:2 01:2 00:2 01:2 00:2 01:2 00:2 01:2 00:2 01:2 00:2 01:2 00:2 01:2 00:2 01:2 00:2 01:2
19:1 12:2 19:1 19:1 19:1 19:1 24:1 25:1 26:1 27:1 28:1 29:1 19:1 19:1 19:1 19:1 19:1 19:1 19:1 19:1 19:1 19:1 19:1 19:1 19:1 19:1 19:1 19:1 19:1 19:1
19:1 06:2 19:1 19:1 19:1 19:1 30:1 31:1 32:3 33:3 34:1 35:1 19:1 19:1 19:1 19:1 19:1 19:1 19:1 19:1 19:1 19:1 19:1 19:1 19:1 19:1 19:1 19:1 19:1 19:1
19:1 12:2 19:1 19:1 19:1 19:1 36:1 37:1 38:3 39:3 40:1 41:1 19:1 19:1 19:1 19:1 19:1 19:1 19:1 19:1 19:1 19:1 19:1 19:1 19:1 19:1 19:1 19:1 19:1 19:1
19:1 06:2 19:1 19:1 19:1 19:1 42:1 43:1 44:1 45:1 46:1 47:1 19:1 19:1 19:1 19:1 19:1 19:1 19:1 19:1 19:1 19:1 19:1 19:1 19:1 19:1 19:1 19:1 19:1 19:1
19:1 12:2 19:1 19:1 19:1 19:1 00:2 01:2 00:2 01:2 00:2 01:2 19:1 19:1 19:1 19:1 19:1 19:1 19:1 19:1 19:1 19:1 19:1 19:1 19:1 19:1 19:1 19:1 19:1 19:1
19:1 06:2 19:1 19:1 19:1 19:1 19:1 19:1 19:1 19:1 19:1 19:1 19:1 19:1 19:1 19:1 19:1 19:1 19:1 19:1 19:1 19:1 19:1 19:1 19:1 19:1 19:1 19:1 19:1 19:1
19:1 12:2 19:1 19:1 19:1 19:1 19:1 19:1 19:1 19:1 19:1 19:1 19:1 19:1 19:1 19:1 19:1 19:1 19:1 19:1 19:1 19:1 19:1 19:1 19:1 19:1 19:1 19:1 19:1 19:1
19:1 06:2 19:1 19:1 19:1 19:1 19:1 19:1 19:1 19:1 19:1 19:1 19:1 19:1 19:1 19:1 19:1 19:1 19:1 19:1 19:1 19:1 19:1 19:1 19:1 19:1 19:1 19:1 19:1 19:1
19:2 12:2 00:2 01:2 00:2 01:2 00:2 01:2 00:2 01:2 00:2 01:2 00:2 01:2 00:2 01:2 00:2 01:2 00:2 01:2 00:2 01:2 00:2 01:2 00:2 01:2 00:2 01:2 00:2 01:2