00:2 01:2 00:2 01:2 00:2 01:2 00:2 01:2 00:2 01:2 00:2 01:2 00:2 01:2 00:2 01:2 00:2 01:2 00:2 01:2 00:2 01:2 00:2 01:2 00:2 01:2 00:2 01:2 06:2 19:1
19:1 19:1 19:1 19:1 19:1 19:1 19:1 19:1 19:1 19:1 19:1 19:1 19:1 19:1 19:1 19:1 19:1 19:1 19:1 19:1 19:1 19:1 19:1 19:1 19:1 19:1 19:1 19:1 12:2 19:1
19:1 19:1 19:1 19:1 19:1 19:1 19:1 19:1 19:1 19:1 19:1 19:1 19:1 19:1 19:1 19:1 19:1 19:1 19:1 19:1 19:1 19:1 19:1 19:1 19:1 19:1 19:1 19:1 06:2 19:1
19:1 19:1 19:1 19:1 19:1 19:1 19:1 19:1 19:1 19:1 19:1 19:1 19:1 19:1 19:1 19:1 19:1 19:1 19:1 19:1 19:1 19:1 19:1 19:1 19:1 19:1 19:1 19:1 12:2 19:1
19:1 19:1 19:1 19:1 19:1 19:1 19:1 19:1 19:1 19:1 19:1 19:1 19:1 19:1 19:1 19:1 19:1 19:1 19:1 19:1 19:1 19:1 19:1 19:1 19:1 19:1 19:1 19:1 06:2 19:1
19:1 19:1 19:1 19:1 19:1 19:1 19:1 19:1 19:1 19:1 19:1 19:1 19:1 19:1 19:1 19:1 19:1 19:1 19:1 19:1 19:1 19:1 19:1 19:1 19:1 19:1 19:1 19:1 12:2 19:1
19:1 19:1 19:1 19:1 19:1 19:1 19:1 19:1 19:1 19:1 19:1 19:1 19:1 19:1 19:1 19:1 19:1 19:1 19:1 19:1 19:1 19:1 19:1 19:1 19:1 19:1 19:1 19:1 06:2 19:1
19:1 19:1 19:1 19:1 14:1 15:1 19:1 19:1 19:1 19:1 19:1 19:1 19:1 19:1 19:1 19:1 19:1 19:1 19:1 19:1 19:1 19:1 19:1 19:1 19:1 19:1 19:1 19:1 12:2 19:1
19:1 19:1 19:1 19:1 20:1 21:1 19:1 19:1 19:1 19:1 19:1 19:1 19:1 19:1 19:1 19:1 19:1 19:1 19:1 19:1 19:1 19:1 19:1 19:1 19:1 19:1 19:1 19:1 06:2 19:1
00:2 01:2 00:2 01:2 00:2 01:2 00:2 01:2 19:1 19:1 19:1 19:1 19:1 19:1 19:1 19:1 19:1 19:1 19:1 19:1 19:1 19:1 19:1 19:1 19:1 19:1 19:1 19:1 12:2 19:1