19:1 19:1 19:1 19:1 19:1 19:1 19:1 19:1 19:1 19:1 19:1 19:1 00:2 01:2 19:1 19:1 19:1 19:1 19:1 19:1 19:1 19:1 19:1 19:1 19:1 19:1 19:1 19:1 06:2 19:1
19:1 19:1 19:1 19:1 19:1 19:1 19:1 19:1 19:1 19:1 19:1 19:1 19:1 19:1 19:1 19:1 19:1 19:1 19:1 19:1 19:1 19:1 19:1 19:1 19:1 19:1 19:1 19:1 12:2 19:1
19:1 19:1 19:1 19:1 19:1 19:1 19:1 19:1 19:1 19:1 19:1 19:1 19:1 19:1 19:1 19:1 00:2 01:2 00:2 01:2 19:1 19:1 19:1 19:1 19:1 19:1 19:1 19:1 06:2 19:1
19:1 19:1 19:1 19:1 19:1 19:1 19:1 19:1 19:1 19:1 19:1 19:1 19:1 19:1 19:1 19:1 19:1 19:1 19:1 19:1 19:1 19:1 19:1 19:1 19:1 19:1 19:1 19:1 12:2 19:1
19:1 19:1 19:1 19:1 19:1 19:1 19:1 19:1 19:1 19:1 19:1 19:1 19:1 19:1 19:1 19:1 19:1 19:1 19:1 19:1 19:1 19:1 19:1 19:1 19:1 19:1 19:1 19:1 06:2 19:1
19:1 19:1 19:1 19:1 19:1 19:1 19:1 19:1 19:1 19:1 19:1 19:1 19:1 19:1 19:1 19:1 19:1 19:1 19:1 19:1 00:2 01:2 00:2 01:2 19:1 19:1 19:1 19:1 12:2 19:1
19:1 19:1 19:1 19:1 19:1 19:1 19:1 19:1 19:1 19:1 19:1 19:1 19:1 19:1 19:1 19:1 19:1 19:1 19:1 19:1 19:1 19:1 19:1 19:1 19:1 19:1 19:1 19:1 06:2 19:1
19:1 19:1 19:1 19:1 19:1 19:1 19:1 19:1 19:1 19:1 19:1 19:1 19:1 19:1 19:1 19:1 19:1 19:1 19:1 19:1 19:1 19:1 19:1 19:1 19:1 19:1 19:1 19:1 12:2 19:1
19:1 19:1 19:1 19:1 19:1 19:1 19:1 19:1 19:1 19:1 19:1 19:1 19:1 19:1 19:1 19:1 19:1 19:1 19:1 19:1 19:1 19:1 19:1 19:1 19:1 19:1 19:1 19:1 06:2 19:1
00:2 01:2 00:2 01:2 00:2 01:2 00:2 01:2 00:2 01:2 00:2 01:2 00:2 01:2 00:2 01:2 00:2 01:2 00:2 01:2 00:2 01:2 00:2 01:2 00:2 01:2 00:2 01:2 12:2 19:1