19:2 19:1 19:1 19:1 19:1 19:1 19:1 19:1 19:1 19:1 19:1 19:1 49:1 19:1 19:1 19:1 19:1 19:1 19:1 19:1 19:1 19:1 19:1 19:1 19:1 19:1 19:1 19:1 19:1 19:1
19:2 19:1 19:1 19:1 19:1 19:1 19:1 19:1 19:1 19:1 19:1 19:1 48:1 19:1 19:1 19:1 19:1 19:1 19:1 19:1 19:1 19:1 19:1 19:1 19:1 19:1 19:1 19:1 19:1 19:1
19:2 19:1 19:1 19:1 19:1 19:1 19:1 00:2 01:2 00:2 01:2 00:2 01:2 00:2 01:2 00:2 01:2 00:2 01:2 00:2 01:2 00:2 01:2 00:2 01:2 00:2 01:2 19:1 19:1 19:1
19:2 19:1 19:1 19:1 19:1 19:1 19:1 19:1 19:1 19:1 19:1 19:1 19:1 19:1 19:1 19:1 19:1 19:1 19:1 19:1 19:1 19:1 19:1 19:1 19:1 19:1 19:1 19:1 19:1 19:1
19:2 19:1 19:1 19:1 19:1 00:2 01:2 19:1 19:1 19:1 19:1 19:1 19:1 19:1 19:1 19:1 19:1 19:1 19:1 19:1 19:1 19:1 19:1 19:4 19:4 19:4 19:4 19:4 19:4 19:4
19:2 19:1 19:1 19:1 19:1 19:1 19:1 19:1 19:1 19:1 19:1 19:1 19:1 19:1 19:1 19:1 19:1 19:1 19:1 19:1 19:1 19:1 19:1 19:1 19:1 19:1 19:1 19:1 19:1 19:1
19:2 19:1 00:2 01:2 19:1 19:1 19:1 19:1 19:1 19:1 19:1 19:1 19:1 19:1 19:1 19:1 19:1 19:1 19:1 19:1 19:1 19:1 19:1 19:1 19:1 19:1 19:1 19:1 19:1 19:1
19:2 19:1 19:1 19:1 19:1 19:1 19:1 19:1 19:1 19:1 19:1 19:1 19:1 19:1 19:1 19:1 19:1 19:1 19:1 19:1 19:1 19:1 19:1 19:1 19:1 19:1 19:1 19:1 19:1 19:1
19:2 19:1 19:1 19:1 00:2 01:2 19:1 19:1 19:1 19:1 19:1 19:1 19:1 19:1 19:1 19:1 19:1 19:1 19:1 19:1 19:1 19:1 19:1 19:1 19:1 19:1 19:1 19:1 19:1 19:1
19:2 19:1 19:1 19:1 19:1 19:1 19:1 00:2 01:2 19:1 19:1 19:1 19:1 19:1 19:1 19:1 19:1 19:1 19:1 19:1 19:1 19:1 19:1 19:1 19:1 19:1 19:1 19:1 19:1 19:1