19:2 06:2 19:1 19:1 19:1 19:1 19:1 19:1 19:1 19:1 19:1 19:1 19:1 19:1 19:1 19:1 19:1 19:1 19:1 19:1 19:1 19:1 19:1 19:1 19:1 19:1 19:1 19:1 19:1 19:1
19:2 12:2 19:1 19:1 19:1 19:1 19:1 19:1 19:1 19:1 19:1 19:1 19:1 19:1 19:1 00:2 01:2 00:2 01:2 19:1 19:1 19:1 19:1 19:1 19:1 19:1 19:1 19:1 19:1 19:1
19:2 06:2 19:1 19:1 19:1 19:1 19:1 19:1 19:1 19:1 19:1 19:1 19:1 19:1 19:1 19:1 19:1 19:1 19:1 19:1 19:1 19:1 19:1 19:1 19:1 00:2 01:2 19:1 19:1 19:1
19:2 12:2 19:1 19:1 19:1 19:1 19:1 19:1 19:1 16:1 17:1 19:1 19:1 19:1 19:1 19:1 19:1 19:1 19:1 19:1 19:1 19:1 19:1 19:1 19:1 19:1 19:1 19:1 19:1 19:1
19:2 06:2 19:1 19:1 19:1 19:1 19:1 19:1 19:1 22:1 23:1 19:1 19:1 19:1 19:1 19:1 19:1 19:1 19:1 19:1 19:1 19:1 19:1 19:1 19:1 19:1 19:1 19:1 19:1 19:1
19:2 12:2 19:1 19:1 19:1 19:1 19:1 19:1 00:2 01:2 00:2 01:2 00:2 01:2 19:1 19:1 19:1 19:1 19:1 19:1 19:1 19:1 19:1 19:1 19:1 19:1 19:1 19:1 19:1 19:1
19:2 06:2 19:1 19:1 19:1 19:1 19:1 19:1 19:1 19:1 19:1 19:1 19:1 19:1 19:1 19:1 19:1 19:1 19:1 19:1 19:1 19:1 19:1 19:1 19:1 19:1 19:1 19:1 19:1 19:1
19:2 12:2 19:1 19:1 19:1 19:1 19:1 19:1 19:1 19:1 19:1 19:1 19:1 19:1 19:1 19:1 19:1 19:1 19:1 00:2 01:2 00:2 01:2 00:2 01:2 19:1 19:1 19:1 19:1 19:1
19:2 00:2 01:2 00:2 01:2 00:2 01:2 19:1 19:1 19:1 19:1 19:1 19:1 19:1 19:1 19:1 19:1 19:1 19:1 19:1 19:1 19:1 19:1 19:1 19:1 19:1 19:1 19:1 19:1 19:1
19:2 19:4 19:4 19:4 19:4 19:4 19:4 19:4 19:4 19:4 19:4 19:4 19:4 19:4 19:4 19:4 19:4 19:4 19:4 19:4 19:4 19:4 19:4 19:4 19:4 19:4 19:4 19:4 19:4 19:4